12,20
0000000010
0003000010
0033300010
0003000010
0000000010
0444400010
0444400010
0444400010
0444400010
0000000000